TABELA DE JOGOS

---------- Rodada 1 ----------
Jogo 1: Guardiões FC x SE Leões	Cidade: Guardião
Jogo 2: Simba FC x SE Granada	Cidade: Leão
Jogo 3: Porto EC x Solaris RC	Cidade: Porto
Jogo 4: Campos FC x CA Protetores	Cidade: Campos
Jogo 5: Secretos FC x Portuários AA	Cidade: Escondidos
Jogo 6: CA Lagos x Ferroviária EC	Cidade: Lagos
Jogo 7: CA Azedos x SE Escondidos	Cidade: Limões

---------- Rodada 2 ----------
Jogo 1: Guardiões FC x Ferroviária EC	Cidade: Guardião
Jogo 2: Simba FC x CA Azedos	Cidade: Leão
Jogo 3: Portuários AA x CA Protetores	Cidade: Porto
Jogo 4: Campos FC x SE Leões	Cidade: Campos
Jogo 5: SE Escondidos x SE Granada	Cidade: Escondidos
Jogo 6: CA Lagos x Porto EC	Cidade: Lagos
Jogo 7: Solaris RC x Secretos FC	Cidade: Ponte-do-Sol

---------- Rodada 3 ----------
Jogo 1: Guardiões FC x SE Escondidos	Cidade: Guardião
Jogo 2: SE Leões x Campos FC	Cidade: Leão
Jogo 3: Porto EC x CA Lagos	Cidade: Porto
Jogo 4: Ferroviária EC x Portuários AA	Cidade: Campos
Jogo 5: Secretos FC x Simba FC	Cidade: Escondidos
Jogo 6: SE Granada x CA Azedos	Cidade: Granada
Jogo 7: Solaris RC x CA Protetores	Cidade: Ponte-do-Sol

---------- Rodada 4 ----------
Jogo 1: Guardiões FC x Porto EC	Cidade: Guardião
Jogo 2: SE Leões x Secretos FC	Cidade: Leão
Jogo 3: Portuários AA x Solaris RC	Cidade: Porto
Jogo 4: Ferroviária EC x Campos FC	Cidade: Campos
Jogo 5: SE Escondidos x CA Protetores	Cidade: Escondidos
Jogo 6: CA Lagos x Simba FC	Cidade: Lagos
Jogo 7: CA Azedos x SE Granada	Cidade: Limões

---------- Rodada 5 ----------
Jogo 1: Guardiões FC x SE Granada	Cidade: Guardião
Jogo 2: Simba FC x Portuários AA	Cidade: Leão
Jogo 3: Porto EC x CA Azedos	Cidade: Porto
Jogo 4: Ferroviária EC x CA Protetores	Cidade: Campos
Jogo 5: SE Escondidos x SE Leões	Cidade: Escondidos
Jogo 6: CA Lagos x Secretos FC	Cidade: Lagos
Jogo 7: Solaris RC x Campos FC	Cidade: Ponte-do-Sol

---------- Rodada 6 ----------
Jogo 1: Guardiões FC x Campos FC	Cidade: Guardião
Jogo 2: Simba FC x SE Escondidos	Cidade: Leão
Jogo 3: Porto EC x CA Protetores	Cidade: Porto
Jogo 4: Ferroviária EC x SE Leões	Cidade: Campos
Jogo 5: Secretos FC x CA Lagos	Cidade: Escondidos
Jogo 6: SE Granada x Portuários AA	Cidade: Granada
Jogo 7: CA Azedos x Solaris RC	Cidade: Limões

---------- Rodada 7 ----------
Jogo 1: CA Protetores x Ferroviária EC	Cidade: Guardião
Jogo 2: Simba FC x Guardiões FC	Cidade: Leão
Jogo 3: Portuários AA x SE Granada	Cidade: Porto
Jogo 4: Campos FC x Porto EC	Cidade: Campos
Jogo 5: SE Escondidos x Solaris RC	Cidade: Escondidos
Jogo 6: CA Lagos x SE Leões	Cidade: Lagos
Jogo 7: CA Azedos x Secretos FC	Cidade: Limões

---------- Rodada 8 ----------
Jogo 1: CA Protetores x Porto EC	Cidade: Guardião
Jogo 2: Simba FC x Campos FC	Cidade: Leão
Jogo 3: Portuários AA x SE Escondidos	Cidade: Porto
Jogo 4: Ferroviária EC x Guardiões FC	Cidade: Campos
Jogo 5: Secretos FC x CA Azedos	Cidade: Escondidos
Jogo 6: CA Lagos x SE Granada	Cidade: Lagos
Jogo 7: Solaris RC x SE Leões	Cidade: Ponte-do-Sol

---------- Rodada 9 ----------
Jogo 1: Guardiões FC x Simba FC	Cidade: Guardião
Jogo 2: SE Leões x Porto EC	Cidade: Leão
Jogo 3: Portuários AA x Campos FC	Cidade: Porto
Jogo 4: Ferroviária EC x Secretos FC	Cidade: Campos
Jogo 5: SE Escondidos x CA Azedos	Cidade: Escondidos
Jogo 6: CA Lagos x CA Protetores	Cidade: Lagos
Jogo 7: Solaris RC x SE Granada	Cidade: Ponte-do-Sol

---------- Rodada 10 ----------
Jogo 1: Guardiões FC x CA Azedos	Cidade: Guardião
Jogo 2: Simba FC x CA Protetores	Cidade: Leão
Jogo 3: Portuários AA x SE Leões	Cidade: Porto
Jogo 4: Campos FC x SE Granada	Cidade: Campos
Jogo 5: Secretos FC x Porto EC	Cidade: Escondidos
Jogo 6: CA Lagos x SE Escondidos	Cidade: Lagos
Jogo 7: Solaris RC x Ferroviária EC	Cidade: Ponte-do-Sol

---------- Rodada 11 ----------
Jogo 1: CA Protetores x SE Leões	Cidade: Guardião
Jogo 2: Simba FC x Porto EC	Cidade: Leão
Jogo 3: Portuários AA x Secretos FC	Cidade: Porto
Jogo 4: Campos FC x Solaris RC	Cidade: Campos
Jogo 5: SE Escondidos x Guardiões FC	Cidade: Escondidos
Jogo 6: SE Granada x Ferroviária EC	Cidade: Granada
Jogo 7: CA Azedos x CA Lagos	Cidade: Limões

---------- Rodada 12 ----------
Jogo 1: CA Protetores x CA Lagos	Cidade: Guardião
Jogo 2: SE Leões x CA Azedos	Cidade: Leão
Jogo 3: Porto EC x Simba FC	Cidade: Porto
Jogo 4: Campos FC x Guardiões FC	Cidade: Campos
Jogo 5: SE Escondidos x Ferroviária EC	Cidade: Escondidos
Jogo 6: SE Granada x Secretos FC	Cidade: Granada
Jogo 7: Solaris RC x Portuários AA	Cidade: Ponte-do-Sol

---------- Rodada 13 ----------
Jogo 1: CA Protetores x SE Escondidos	Cidade: Guardião
Jogo 2: SE Leões x SE Granada	Cidade: Leão
Jogo 3: Portuários AA x Simba FC	Cidade: Porto
Jogo 4: Ferroviária EC x Porto EC	Cidade: Campos
Jogo 5: Secretos FC x Campos FC	Cidade: Escondidos
Jogo 6: CA Lagos x Solaris RC	Cidade: Lagos
Jogo 7: CA Azedos x Guardiões FC	Cidade: Limões

---------- Rodada 14 ----------
Jogo 1: Guardiões FC x Solaris RC	Cidade: Guardião
Jogo 2: Simba FC x Secretos FC	Cidade: Leão
Jogo 3: Portuários AA x CA Lagos	Cidade: Porto
Jogo 4: Campos FC x Ferroviária EC	Cidade: Campos
Jogo 5: SE Escondidos x Porto EC	Cidade: Escondidos
Jogo 6: SE Granada x SE Leões	Cidade: Granada
Jogo 7: CA Azedos x CA Protetores	Cidade: Limões

---------- Rodada 15 ----------
Jogo 1: CA Protetores x Portuários AA	Cidade: Guardião
Jogo 2: Simba FC x CA Lagos	Cidade: Leão
Jogo 3: Porto EC x SE Leões	Cidade: Porto
Jogo 4: Campos FC x SE Escondidos	Cidade: Campos
Jogo 5: Secretos FC x Guardiões FC	Cidade: Escondidos
Jogo 6: SE Granada x Solaris RC	Cidade: Granada
Jogo 7: CA Azedos x Ferroviária EC	Cidade: Limões

---------- Rodada 16 ----------
Jogo 1: Guardiões FC x Secretos FC	Cidade: Guardião
Jogo 2: SE Leões x CA Protetores	Cidade: Leão
Jogo 3: Porto EC x Portuários AA	Cidade: Porto
Jogo 4: Ferroviária EC x CA Azedos	Cidade: Campos
Jogo 5: SE Escondidos x Campos FC	Cidade: Escondidos
Jogo 6: SE Granada x CA Lagos	Cidade: Granada
Jogo 7: Solaris RC x Simba FC	Cidade: Ponte-do-Sol

---------- Rodada 17 ----------
Jogo 1: CA Protetores x Secretos FC	Cidade: Guardião
Jogo 2: SE Leões x Guardiões FC	Cidade: Leão
Jogo 3: Porto EC x SE Granada	Cidade: Porto
Jogo 4: Ferroviária EC x Solaris RC	Cidade: Campos
Jogo 5: SE Escondidos x Simba FC	Cidade: Escondidos
Jogo 6: CA Lagos x Portuários AA	Cidade: Lagos
Jogo 7: CA Azedos x Campos FC	Cidade: Limões

---------- Rodada 18 ----------
Jogo 1: Guardiões FC x CA Protetores	Cidade: Guardião
Jogo 2: SE Leões x Ferroviária EC	Cidade: Leão
Jogo 3: Portuários AA x Porto EC	Cidade: Porto
Jogo 4: Campos FC x CA Lagos	Cidade: Campos
Jogo 5: Secretos FC x Solaris RC	Cidade: Escondidos
Jogo 6: SE Granada x SE Escondidos	Cidade: Granada
Jogo 7: CA Azedos x Simba FC	Cidade: Limões

---------- Rodada 19 ----------
Jogo 1: CA Protetores x Simba FC	Cidade: Guardião
Jogo 2: SE Leões x SE Escondidos	Cidade: Leão
Jogo 3: Portuários AA x Ferroviária EC	Cidade: Porto
Jogo 4: Campos FC x CA Azedos	Cidade: Campos
Jogo 5: Secretos FC x SE Granada	Cidade: Escondidos
Jogo 6: CA Lagos x Guardiões FC	Cidade: Lagos
Jogo 7: Solaris RC x Porto EC	Cidade: Ponte-do-Sol

---------- Rodada 20 ----------
Jogo 1: CA Protetores x Campos FC	Cidade: Guardião
Jogo 2: SE Leões x Solaris RC	Cidade: Leão
Jogo 3: Portuários AA x Guardiões FC	Cidade: Porto
Jogo 4: Ferroviária EC x CA Lagos	Cidade: Campos
Jogo 5: Secretos FC x SE Escondidos	Cidade: Escondidos
Jogo 6: SE Granada x Simba FC	Cidade: Granada
Jogo 7: CA Azedos x Porto EC	Cidade: Limões

---------- Rodada 21 ----------
Jogo 1: Guardiões FC x Portuários AA	Cidade: Guardião
Jogo 2: SE Leões x Simba FC	Cidade: Leão
Jogo 3: Porto EC x SE Escondidos	Cidade: Porto
Jogo 4: Ferroviária EC x SE Granada	Cidade: Campos
Jogo 5: Secretos FC x CA Protetores	Cidade: Escondidos
Jogo 6: CA Lagos x Campos FC	Cidade: Lagos
Jogo 7: Solaris RC x CA Azedos	Cidade: Ponte-do-Sol

---------- Rodada 22 ----------
Jogo 1: CA Protetores x CA Azedos	Cidade: Guardião
Jogo 2: SE Leões x Portuários AA	Cidade: Leão
Jogo 3: Porto EC x Guardiões FC	Cidade: Porto
Jogo 4: Ferroviária EC x Simba FC	Cidade: Campos
Jogo 5: SE Escondidos x Secretos FC	Cidade: Escondidos
Jogo 6: SE Granada x Campos FC	Cidade: Granada
Jogo 7: Solaris RC x CA Lagos	Cidade: Ponte-do-Sol

---------- Rodada 23 ----------
Jogo 1: CA Protetores x Solaris RC	Cidade: Guardião
Jogo 2: Simba FC x Ferroviária EC	Cidade: Leão
Jogo 3: Porto EC x Secretos FC	Cidade: Porto
Jogo 4: Campos FC x Portuários AA	Cidade: Campos
Jogo 5: SE Escondidos x CA Lagos	Cidade: Escondidos
Jogo 6: SE Granada x Guardiões FC	Cidade: Granada
Jogo 7: CA Azedos x SE Leões	Cidade: Limões

---------- Rodada 24 ----------
Jogo 1: CA Protetores x Guardiões FC	Cidade: Guardião
Jogo 2: SE Leões x CA Lagos	Cidade: Leão
Jogo 3: Portuários AA x CA Azedos	Cidade: Porto
Jogo 4: Campos FC x Simba FC	Cidade: Campos
Jogo 5: Secretos FC x Ferroviária EC	Cidade: Escondidos
Jogo 6: SE Granada x Porto EC	Cidade: Granada
Jogo 7: Solaris RC x SE Escondidos	Cidade: Ponte-do-Sol

---------- Rodada 25 ----------
Jogo 1: CA Protetores x SE Granada	Cidade: Guardião
Jogo 2: Simba FC x SE Leões	Cidade: Leão
Jogo 3: Porto EC x Ferroviária EC	Cidade: Porto
Jogo 4: Campos FC x Secretos FC	Cidade: Campos
Jogo 5: SE Escondidos x Portuários AA	Cidade: Escondidos
Jogo 6: CA Lagos x CA Azedos	Cidade: Lagos
Jogo 7: Solaris RC x Guardiões FC	Cidade: Ponte-do-Sol

---------- Rodada 26 ----------
Jogo 1: Guardiões FC x CA Lagos	Cidade: Guardião
Jogo 2: Simba FC x Solaris RC	Cidade: Leão
Jogo 3: Porto EC x Campos FC	Cidade: Porto
Jogo 4: Ferroviária EC x SE Escondidos	Cidade: Campos
Jogo 5: Secretos FC x SE Leões	Cidade: Escondidos
Jogo 6: SE Granada x CA Protetores	Cidade: Granada
Jogo 7: CA Azedos x Portuários AA	Cidade: Limões

